NO 				textures/wall_morgul.xpm
SO             textures/wall_morgul.xpm
WE 				textures/wall_morgul.xpm
EA    textures/wall_morgul.xpm

F 			textures/morgul_floor.xpm
   C		textures/morgul_ceil.xpm

1111111111111111111111111111111111111111111111111111111
10000000A1000000000000000000000000000000000000010000001
100000000100000000000000000001110000000000000001000S001
100000000D000000000000000000010100000000000000010000001
1111111111000000000000000000011100000000000000010000001
1000000000000000000000000000000000000000000000000000001
1000000000000000000000000000000000000A00000000000000001
1111111111111111111111111111000000000000000000000000001
1000000000000000000000000001111D111111111111111111D1111
1000000000000000000000000001000000010000000000000000001
1000000111000000000010000001000000010000000A00000000001
10000001A0000000000010000001000000010000000000000000001
10000001A0000000000010000001000000010000001111111111111
10000001A000000000001000000D000000010000000000000000001
1000000111000000000010000001000000010000000000000000001
1000000000000000000010000001000000010000000000000000001
10000000000000000000100000010000000000000000000A0000001
10000000000000000000100000010000000000000000000A0000001
10000000000000000000100000010000000000000000000A0000001
1000000000000000000000000001000000000000000000000000001
1000000000000000000000000001000000000000000000000000001
1111111111111111111111111111111111111111111111111111111
